11 11 01
XXXXXXXXXXX
XXXXX.XXXXX
X...XXX...X
X..IG.GI..X
XXXJ.G.JXXX
XXX.JIJ.XXX
XXXJ.G.JXXX
X..IGMGI..X
X...XXX...X
XXXXX.XXXXX
XXXXXXXXXXX
