08 08 05
XXXXXXXX
XX.XX..X
X.J.JJ.X
XGXM...X
XGXJXX.X
X...JG.X
X..G..GX
XXXXXXXX
