08 08 05
XXXXXXXX
XX.XX..X
X......X
XIX....X
XIX.XX.X
X.I..I.X
X..I..IX
XXXXXXXX
