22 11 06
XXXXXXXXXXXXXXXXXXXXXX
XXXXX...XXXXXXXXXXXXXX
XXXXXJ..XXXXXXXXXXXXXX
XXXXX..JXXXXXXXXXXXXXX
XXX..J..J.XXXXXXXXXXXX
XXX.X.XXX.XXXXXXXXXXXX
X...X.XXX.XXXXXXX..GGX
X.J..J.............GGX
XXXXX.XXXX.XMXXXX..GGX
XXXXX......XXXXXXXXXXX
XXXXXXXXXXXXXXXXXXXXXX
