08 08 05
XXXXXXXX
XX.XX..X
X.J.JJ.X
XGXMX..X
XGXIXX.X
X..GJG.X
X.....GX
XXXXXXXX
